7
Santarem   Leiria     Guarda     Viseu      Braga      VilaReal   Braganca   
0,00       57,98      188,74     171,10     257,66     243,11     328,95     
57,98      0,00       157,68     126,30     202,27     194,60     286,54     
188,74     157,68     0,00       56,13      148,36     93,77      147,27     
171,10     126,30     56,13      0,00       107,81     73,07      160,24     
257,66     202,27     148,36     107,81     0,00       63,20      141,67     
243,11     194,60     93,77      73,07      63,20      0,00       99,39      
328,95     286,54     147,27     160,24     141,67     99,39      0,00 